1111111111111111111111111111111111111111
1000000000000000000000000000000000000001
1000000000000000000000000000000000000001
1001111111111111111111111111111111111001
1001000000000000000000000000000000001001
1001000000000000000000000000000000001001
1001000000000000000000000000000000001001
1001000000000000000000000000000001001001
1001000000000000000000000000000001001001
1001000000000000000000000000000001001001
1001000000000000000000000000000001001001
1001000000000000000000000000000001001001
1001000000000000000000000000000001001001
1001000000000000000000000000000001001001
1001000000000000000000000000000001001001
1001000000000000000000000000000001001001
1001000000000000000000000000000001001001
1001000000000000000000000000000001001001
1001000000000000000000000000000001001001
1001000000000000000000000000000001001001
1001000000000000000000000000000001001001
1001000000000000000000000000000001001001
1001000000000000000000000000000001001001
1001111111111111111111111111111111001001
1000000000000000000000000000000000001001
1000000000000000000000000000000000001001
1001111111111111111111111111111111111001
1000000000000000000000000000000000000001
1000000000000000000000000000000000000001
1111111111111111111111111111111111111111